10.ab
b..b......
..........
.b........
....b.....
..........
b.........
.........b
...b......
..b..b....
..........
